Actor1  Actor2
SWEENEY, MICHELLE	RIFKIN, RON
YUEN, BIAO	WHITE, JAMIE CHRISTOPHER
WISE, JIM (I)	STANFORD, JAXON
TALWAR, SANJAY	SCOTT, MALCOLM (IV)
STECKLEIN, TYNE	SCRIMM, ANGUS
WILCOX II, DOUGLAS	REIM, DONNA GLEE
TÈCSY, S·NDOR	RYAN, AMY (I)
RODRIGUEZ, ANTHONY (I)	WITZKE, JEFF
TODOROFF, TOM	WILLIAMS, BILLY DEE
WLASCHIHA, TOM	REILLY, CORINNE (I)
STRAM, HENRY	SKOOG, OREN
WOODWARD, TIM (I)	SELMOUR, RON
PRICE, JUSTIN (III)	SEDARIS, AMY
SHENKMAN, BEN (II)	TOMASINO, VANESA
WILLIAMS, BILLY 'SLY'	STILWELL, DICK
ROGERS, GREG (I)	RIVERS, VICTOR (I)
ROBINSON, PAUL MICHAEL	SHORT, MARTIN (I)
POE, ARVELL	SUSSER, CRAIG
TERGESEN, LEE	WASHINGTON, KERRY (I)
PRESSMAN, LAWRENCE	TREJO, DANNY
WILLIAMS, MALINDA	SOOD, MANOJ
RADER-DUVAL, DEAN	RUSSO, JAMES (I)
TORRES, GINA (I)	WOZNIAK, MICHAEL
SANDER, CASEY	SPANO, JOE
TOPIC, VELIBOR	WALSH, KATE (I)
PONCE, CARLOS	POLITI, TERESA
TORRENS, PIP	WHITMAN, MAE
STRATHAIRN, DAVID	SHALHOUB, TONY
WRIGHT, CARL (I)	YOUNG, BRUCE A.
ROGERS, REG (I)	ROOSEVELT, FRANKLIN D.
THOMAS, ROSS (II)	TESSIERO, MICHAEL A.
YUAN, RON	TURNER, LAWRENCE
SWEENEY, JULIA	VODENICHAROV, KALOIAN
SPARROW, DAVID (I)	SCOZZARI, FRANK
ZIMA, YVONNE	VAN PATTEN, JAMES (I)
SHEPARD, SAM	PLIMPTON, MARTHA
Q, MAGGIE	WALLACE, GEORGE (I)
SHEFFER, CRAIG	QUALLS, DJ
STAHL, ANDY (I)	SCOTT, ASHLEY (II)
TOMPKINS, MATTHEW (I)	STREAM
POTTS, JONATHAN (I)	POON, CATHERINE KIM
WILDE, BOB	VITALE, DICK
SMITH-CAMERON, J.	SINGER, MARC (I)
STARNINO, ANNA	STEINBERG, RUSSELL (I)
SCOTT, ESTHER (II)	STEVENS, ANDREW (I)
TOULIATOS, GEORGE	WINN, DOLORES
WINSTON, MATT (I)	YUEN, MO
SHOOK, CAROL	ZAMORA, DEL
SLAVOV, SLAVI	WILLIAMS, IAN PATRICK
VANCE, GREGG	URBANO, MARYANN
TIMBER, ROGER J.	SHANNON, MICHAEL (I)
WRIGHT, NATHAN (I)	VAL, MIKKI
WAGNER, JEFFERSON	ZEHETNER, NORA
RIOTTA, VINCENT	SCHWARZENEGGER, ARNOLD
SMITH, SCOTT ALAN (I)	WILMOT, DAVID (I)
VAN SNELLENBERG, JARED	ROSE, VANYA
RUSSELL, HERBERT (II)	SCHULTZ, ALBERT (I)
ROHR, TONY	TYRRELL, SUSAN
WINSTEAD, MARY ELIZABETH	SAULNIER, TANIA
TAMBLYN, AMBER	SUVARI, MENA
TEALE, OWEN	REDMAN, CHRISTOPHER (I)
STERNHAGEN, FRANCES	SCHNARRE, MONIKA
ROSARIO, MARCIO (I)	WARREN, PAUL (VI)
ROBB, DAVID (I)	RAPAPORT, MICHAEL (I)
SPRADLIN, G.D.	WHITLOCK JR., ISIAH
SMITS, JIMMY	PILATO, JOSEPH
STRUYCKEN, CAREL	TIFFE, ANGELO
VASQUEZ, TIMOTHY A.	RENTERIA, PAUL
TYLER, AISHA	WAGNER, BRETT (I)
SANDOVAL, MIGUEL (I)	SHEPHERD, STEVE JOHN
PRESSMAN, DAVID (I)	RESNIC, ALAN
PUCCI, LOU TAYLOR	ROSS, HUGH (I)
TERAJIMA, SUSUMU	SCHMIDTKE, NED
SHAKESHAFT, JENNY	WILLIAMS, BARBARA (I)
RASUK, VICTOR	PILKINGTON, GEOFF (I)
TORRES, MICHELLE (X)	VANCE, SCHUSTER
RAY, FRED OLEN	REITMAN, JOSEPH D.
SHEFFIELD, TAMIE	ROBERDS, MICHAEL
VISSER, MORNE	STIERS, DAVID OGDEN
ZURER, AYELET	STORMARE, PETER
WILLIAMS, WADE (II)	SMART, AMY
TIEN, JAMES	REYNOLDS, RYAN (I)
WILSON, ANDREW (III)	WILLIAMSON, SCOTT (I)
ZAYAS, DAVID	REY, REYNALDO
SARANDON, SUSAN	RAMSEY, DAVID (I)
WATSON, MUSE	SHEEN, MARTIN
WILSON, DOLAN	YOUNG, ADEN
WALL, BRENDAN (I)	WHITE, WELKER
VOSBURGH, TILLY	WILSON, STUART (II)
SNYDER, YLIAN ALFARO	VAN WINKLE, TRAVIS
YOBA, MALIK	SUMPTER, DONALD
SHOCKNEK, KENT	PLOTNICK, JACK
WOLFF, NAT	SHAUGHNESSY, CHARLES
VENEGAS, ARTURO	RAMOS, DIEZEL (I)
SHORE, NANCY ELLEN	RAE, JAMES
WISE, RAY (I)	WENNINGTON, JON
ROBINSON, BUMPER	SOTO, HAN
WILLIAMS, GARY ANTHONY	SAYLES, JOHN (I)
QUATTROCHI, JAMES	SAHAY, VIK
RUFF, MICHELLE	RAWI, RAAD
ROTH, TIM (I)	STONE, SAM (I)
STAITE, JEWEL	WOLEJNIO, KATARZYNA
WAGNER, ROBERT (I)	ST. JAMES, DAVID
VASQUEZ, PETER MARK	REILLY, SEAN PATRICK
SIMMONS, J. NATHAN	TOM, LAUREN (I)
STREISAND, BARBRA	WATERS, DREW
WAITS, TOM	STAFFORD, JON
RICHINGS, JULIAN	ZUCKERMAN, ERIC (I)
SHAW, PAMELA (II)	RUSSELL, WYATT
WHITWORTH, JOHNNY	TUNIE, TAMARA
RIEHLE, RICHARD	SIMMS, MICHAEL DAVID
SMITH, MICHAEL BAILEY (I)	RODAY, JAMES
WALTERS, ASHLEY (I)	TATUM, BRADFORD
SHEARMAN, ALAN	SANDERSON, WILL
VILLEMAIRE, JAMES	ROBINSON, KENNY (I)
RANDAZZO, STEVEN	RUSSELL, ROBERT (VIII)
STANTON, ROBERT (II)	RAPHAEL, SALLY JESSY
RHIND-TUTT, JULIAN	WILSON, RENO (I)
RUSSELL, KATHERINE JEANIE	WASHINGTON, ROBERT DOUGLAS
WEST, TIMOTHY (I)	WRIGHT, N'BUSHE
SIGLER, JAMIE-LYNN	TURTON, KETT
WIGHT, PETER	YATES, KIM (I)
POTENZA, CHRISTIAN	SIDORA, DREW
REYNOLDS, ANTHONY (I)	STOVALL, LARNELL
RUSSELL, ANTHONY (I)	PIERCE, ERNEST
TRESE, ADAM	SIMMONS, RUSSELL
RITTER, JOHN	SEBASTIAN, LOBO
WHIGHAM, SHEA	SILVER, RON (I)
WISDEN, ROBERT	SKYLER, ROBB
ROBERTS, IAN (I)	STEPP, CRAIG
POPPLEWELL, PAUL	WASSERMAN, JERRY
SAVINI, TOM	WALTERS, JULIE (I)
REYNOLDSON, RONDEL	TANG, HON PING
ROBERTS, SHAWN (II)	SUDDUTH, JORDAN
RAULERSON, STEVE	THIGPEN, SANDRA
STANTON, HARRY DEAN	VAN HOLT, BRIAN
WARREN, KIERSTEN	PRESTON, CARRIE (I)
WENDT, MIKE	POWELL, ESTEBAN
SINCLAIR, KURT	WALKER, ANDREW W.
WALTER, LISA ANN	YOUNG, L. WARREN
SPALL, TIMOTHY	SIRGOOD, OZMAN
SENSENIG, ANDREW	SAPP, BOB
SLATTERY, JOHN (I)	SIVERTSEN, MARK
SHANNON, MICHAEL (V)	REDMAYNE, EDDIE
WALKER, POLLY (II)	POINDEXTER, JERIS
ROMANO, RINO	PUNCH, LUCY
WILSON, DON 'THE DRAGON'	RYUSAKI, BILL M.
SINGER, RACHEL (I)	SAMBRELL, ALDO
RHEA, CAROLINE	Z˙ÒIGA, JOSÈ (I)
PRICE, MATT (I)	SHAMOS, JEREMY
YU, KELVIN (I)	TRIGGER, SARAH
SALATA, ROCCO	SUTCHY, SUSANNE
POPPICK, ERIC	QUIGLEY, LINNEA
STAPLETON, SULLIVAN (I)	ROSS, YOLONDA
STRAWN, AMANDA (I)	SAITO, JAMES (I)
YEN, DONNIE	SHAPS, CYRIL
RULE, JA	SUTTLES, DARNELL
SONGUI, KWASI	ZAPATA, MAYA
VELEZ, IVAN 'FLIPZ'	WARNER, CHRIS (IV)
STEVENS, WARREN A.	TAYLOR, SANDRA (I)
STEWART, THOMAS W.	SANFORD, GARWIN
SHEPHERD, SUZANNE	REIVERS, DAVID
WARREN, STEVE (III)	SOOD, VEENA
TALAI, AMIR	REEVES, PERREY
TREGER, SCOTT L.	THOMAS, J. KAREN
REESE, DELLA	TISDALE, ASHLEY
ROBERSON, DAVID (I)	WINDE, BEATRICE
ROMERO, FERNANDA (II)	STEINFELD, HAILEE
WEVER, MERRITT	SHARP, BURTON
ROBILLARD, KIM	STOCKWELL, DEAN
TODA, TOSHI	SWAN, SERINDA
WILLIAMS-PAISLEY, KIMBERLY	WASHINGTON, JASCHA
RAVERA, GINA	SHRIMPTON, MARK (I)
VICTOR, CHRIS (I)	WEHLE, BRENDA
WAINWRIGHT III, LOUDON	RALPH, SHERYL LEE
PRINCIPE, NICK	WOMICK, BRIANNA
SBRAGIA, MATTIA	SPADE, DAVID
SWARDSON, NICK	THEWLIS, DAVID
SVENSON, BO	SEALE, ORLANDO
VAZQUEZ, YUL	SCHANZ, HEIDI (I)
SMITH, KAVAN	PROSKY, JOHN
PLAZA, AUBREY	VERNON, KATE (I)
WITHERSPOON, REESE	REDDICK, LANCE
RUMNOCK, BOB	RYAN, SHAYNA
TAYLOR, BUCK (I)	ZYLER, DAVID
SMIGEL, ROBERT	WARNOCK, DONALD
POLCYN, BEVERLY	UTAY, WILLIAM
PUTTONEN, MICHAEL	SORVINO, MIRA
WALSH, AMANDA (II)	SWANSON, SCOTT (I)
SMITH, LANE (I)	RODERICK, BRANDE
RILEY, CLAIRE (I)	WALTERS, TERRY (I)
UHLER, RAY	SALOMAA, SONYA
SCOTT, CODIE	TOMPKINS, PAUL F.
ZURK, STEVE	YOUNG, WARWICK
SOMERVILLE, BONNIE	TULAINE, DIKRAN
SMITROVICH, BILL	VAN, ALEX
QUARRY, ROBERT	TSAR, MIKE
SATTLER, BOB	ROIZ, SASHA
WASIKOWSKA, MIA	SCOTT, CAREY
WONG, VICTOR (III)	SIFUENTES, EVERETT
ROSS, JEFFREY (I)	RAPOVSKI, PAUL
SIRAGUSA, PETER	SHELTON, MARLEY
SCHLATTER, CHARLIE	VEZINA, GEORGE J.
SCOTT CASHMAN, CHRISTY	SUMMERS, NEIL (I)
SODERBERG, THEODORE CARL	RUNTE, KURT MAX
SILVERSTONE, ALICIA	WINTERS, SCOTT (I)
THOMPSON, LEA (I)	ZAREMBA, DIANNE
VIDAL, LISA (I)	REES, DENNIS (II)
WEIXLER, JESS (I)	TRANCHANT, ELIZABETH
SILVER, DOROTHY (I)	SYKES, WANDA
WATFORD, MYK	SCHIRRIPA, STEVE
SANDERS, HENRY G.	WHITEHEAD, ROBERT (I)
PITT, BRAD	VICENTE, AL
ZABKA, WILLIAM	THOMPSON, REECE
STACK, TIMOTHY (I)	REX, SIMON (I)
WRIGHT, BRIAN D.	RODD, EVERETT
PICARDO, ROBERT	WAYNE, RICKY
VIGEANT, BILLY 'V'	PIPER, RODDY
ROBERTS, DOUGLAS (I)	STAIT, BRENT
SMITH, BRITTA	ROSENSTEIN, HOWARD (II)
WILLIAMS, MEADOW	ROSS, BRYAN (I)
TREADAWAY, LUKE	STEWART, FRENCH
SCALIA, JACK	WHITE, BETTY (I)
STAFFORD, RON (II)	WARREN, LESLEY ANN
SMERCZAK, RON	SALDANA, ZOE
SHALE, KERRY	YOUNG, BRAD EVERETT
WELLINGTON, JAMES	TRENTINI, PEGGY
SEARCY, NICK	STARR, CASSANDRA
WHITNEY, SEWELL	RICE, BRETT
VASILEV, RAICHO	WADDINGTON, STEVEN
SMITH, GREGORY MARSHALL	PROVAL, DAVID
SMITH, CASSIDY (I)	STEWART, LYNNE MARIE
ROBINSON, WENDY RAQUEL	SEGARI, ROBERT
TAVERNARO, RICHARD (I)	REITZ, RIC
RUSH, DEBORAH	TSANG, KENNETH
PRICE, JAMIESON (I)	SPYBEY-WATERS, DINA
ST. CLAIR, TAYLOR (I)	WEST, ADAM (I)
YASSIN, ALEXANDER	TSO, YEE JEE
PROCTOR, PHIL	VENORA, DIANE
STREEP, MERYL	TODISCO, MARIO
VILLA, EDWIN	WHEELER, ANDREW (I)
SNYDER, RICK (I)	SERNA, PEPE
SEWELL, RUFUS	RUSSO, GIANNI (I)
TANG, KAZU PATRICK	VAN SPRANG, ALAN
SCHELLENBERG, AUGUST	SPARKS, HAL
SIRAVO, JOSEPH	VILLARI, LIBBY
RANKIN, STEVE	PISSORS, WOLFGANG
ROSALES JR., THOMAS	RODRIGUEZ, GARY
REYNOLDS, DEBBIE (I)	SINGER, STEPHEN (I)
STONE, LEE (II)	WESTON, CELIA
WINTERS, JONATHAN	WALLACE, DEE (II)
WALLACH, ELI	ROSENGREN, CLIVE
PRATT, KYLA (II)	TRAVIS, RANDY (I)
PRICE, VINCENT (I)	TORTI, ROBERT
PISCOPO, JOE	STEWART, CATHERINE MARY
SHELTON, SAMANTHA	TEXADA, TIA
SCOTT, LARRY B.	RUSLER, MORGAN
YUNE, RICK	SMITH, YEARDLEY
RHYS-DAVIES, JOHN	TAYLOR, JAMES ARNOLD
RODRÌGUEZ, FREDDY (I)	QUIJADA, ALFONSO
RENNA, MELINDA	WILES, MICHAEL SHAMUS
WAHLGREN, KARI	TAYLOR, FRANK HOYT
SEWELL, CATHERINE (I)	SCHWIMMER, RUSTY
SHEARER, HARRY	WALLACE, JERRY L.
RICHARDSON, SY	TOCHA, PAULO
THOMPSON, KENAN	SIXTEEN, NICKI
TOGUNDE, VICTOR	TOVAH, MAGEINA
RHYMES, BUSTA	POOTS, IMOGEN
STRITCH, ELAINE	STARR, MARTIN
TORMEY, JOHN (I)	YOO, AARON
SCOTT, JILL (II)	SMITH, CAMERON K.
RODRÌGUEZ, MARCO (I)	ROBERTSON, STEVEN (I)
ZAHN, STEVE	THOMAS, KHLEO
SKEWES, MICHAEL	SCORSONE, CATERINA
RENFRO, BRYAN (I)	RYALL, DAVID
SATO, GARRET	SLEZAK, VICTOR
TROWELL, KATHERINE	SHERRILL, DAVID (I)
WARD, KIRK	SARAFYAN, ANGELA
SALSEDO, FRANK	VOGEL, MIKE (I)
WOODARD, ALFRE	WILLIS, MICHAEL (I)
SCHEIDER, ROY	TUPPER, REG
SMITH, KURTWOOD	POLTORANIN, NICK
POOLE, TOM (II)	THOMPSON, AL (II)
SWEENEY, BIRDY	WHITE, JULIE (I)
RODRIGO, AL	POSTER, TOM (I)
STELLATO, FRANK	WILL.I.AM
SMITH, SEAN (II)	TURNER, BREE
RADFORD, NATALIE	RISEBOROUGH, ANDREA
WOOTEN, JOHN (III)	SIMMONS, CHELAN
SIEVERS, GARY	WEAVER, SIGOURNEY
PRESLEY, ELVIS	VENTIMIGLIA, MILO
PRICE, MOLLY	SILLAS, KAREN
SMITH JR., EDDIE BO	THINGVALL, JOEL
WADDELL, JUSTINE	PILEGGI, MITCH
STATHAM, JASON	SINER, GUY
RIFFEL, RENA	WILSON, MICHAEL G. (I)
WILLIAMS, KEITH LEON	PINCHOT, BRONSON
STOTT, KEN	WYNANDS, DANNY
SHOAIB, SAMIA	SUDEIKIS, JASON
RODARTE, MIGUEL (I)	WILLIAMSON, FRED
RICHARDSON, LAURENCE (II)	TENA, NATALIA
RABSON, JAN	SPIELBERG, SASHA
STAPLETON, CHRISTOPHER	STOLTZ, ERIC
ZEPPIERI, RICHARD	SCHWARTZ, TAVIA
SHAW, FIONA	RANDOLPH, DAVID (I)
STRANGE, SARAH	ZIMMERMAN, LEIGH
TAYLOR, ROBERT (VII)	ROBERTS, MATTHEW DYLAN (I)
TWEED, SHANNON (I)	S·NCHEZ PARRA, GUSTAVO
QUINLAN, KATHLEEN	ROMAN, FRANK (I)
TATE, LARENZ	TUDOR-POLE, EDWARD
XUEREB, SALVATOR	REDGRAVE, VANESSA
SCHUB, STEVEN	SULLIVAN, CHARLOTTE (I)
PRENTICE, JORDAN	SAAD, MICHAEL (I)
WARD, DAVE 'SQUATCH'	SUDDUTH, KOHL
YENQUE, JOSE	ZSENYUK, STEVEN PAUL
SHU, QI	ZEMECKIS, LESLIE (I)
WHITAKER, DUANE	SMITH, IVAN (I)
SINCLAIR, PAULETTE	SCARBOROUGH, ADRIAN
TORSEIN, ANNABELLE	WARD, MEGAN (I)
WARD, NANCY E.L.	SANDERS, FRED (I)
URITESCU, BOGDAN	REID, JESSE (I)
RAE, ALEJANDRO	ROMANO, LARRY
YASBECK, AMY	POUDRIER, TODD
VAN COTT, GALE	WILLIAMS, MICHAEL KENNETH
TAYLOR, ELAYN J.	THORBURN, JIM
WIIG, KRISTEN	TRUE-FROST, JIM
WATSON, EMMA (II)	TOMEI, CONCETTA
PRINCE, STEVEN CHESTER	STRUFFOLINO, DAVID
SPINELLI, CHRIS (I)	STERNE, DAVID
ROBERTS, SEAN O.	THICKE, ALAN
WEINSTEIN, SAMANTHA (I)	RUDD, PAUL (I)
WARDEN, RICK (I)	SEGURA, SANTIAGO (I)
RANSOM, KENNETH	STEIN, BEN (I)
SOUALEM, ZINEDINE	SCOTT, TOM EVERETT
STEWART, BOOBOO	POLCE, JOHN
SOTO, TALISA	WEAVER, JACKI
WARE, TIM (I)	PORTMAN, NATALIE
SHELLEN, STEPHEN	POLLACK, SYDNEY
SUTCLIFFE, DAVID (I)	TUCHELSKE, ERIC
SCHEINE, RAYNOR	RUFFALO, MARK
WAGNER, LINDSAY (I)	STRONG, RIDER
RUSSO, TALIA	TAYLOR, DENDRIE
SWANSON, ROCHELLE	RUSH, GEOFFREY
WACHS, CAITLIN	WELCH, CHRISTOPHER EVAN
RYAN, MARISA (I)	WRIGHT, MARCIA (I)
WINGERT, WALLY	STEEN, PAPRIKA
ROBERTS, TREVOR (I)	SANTOS, JOE (I)
THOMPSON, MARK (VI)	RODRIGUEZ, MEL (I)
REASER, ELIZABETH	PRIESTLEY, JASON
WEST, BILLY (II)	ZERINGUE, RICHARD
ZEGERS, KEVIN	SCRIBA, MIK
WU, TOM (I)	WADE, JENNY
ROWE, BRAD (I)	ROSARIO, BERT
ROBERTSON, CLIFF (I)	TERZO, VENUS
SCHRODER, RICKY	ROBBINS, GARRY
PRICE, CONNOR (I)	POST, THOMAS J.
SCOTT, GEORGE C.	WALSH, JOHN (III)
STAMP, TERENCE	WILLIAMS, KATT
STINCHCOMB, BILL (I)	PICKENS JR., JAMES
REEVES, KEANU	YOUNG, HARRISON (I)
ROGSTAD, LEO	RYAN, MEG
SIVERIO, MANNY	POEHLER, AMY
WAGNER, JOBETH	SPALL, RAFE
SEAGREN, STEVE	ROSSI, TONY RAY
WHEELER-NICHOLSON, DANA	REDGRAVE, LYNN
SKLAR, RANDY (I)	REDMAN, DEAN
RUSSELL, REGINA (I)	STRONG, BRENDA
WINTERS, ANTHONY (I)	WALKER, PAUL (I)
SENDAYDIEGO, VIVIENNE	SHEPHERD, CYBILL
WEST, KANYE	SCHREIBER, PABLO
SAVANTE, STELIO	WASHINGTON, ISAIAH (I)
WARING, RAYMOND	SAMBERG, ANDY
WIGGINS, CHRIS (I)	WEYERS, MARIUS
ZIERING, NIKKI	RUSKIN, JOSEPH
XIFARAS, WILLIAM	SHANKS, MICHAEL (I)
SAUNDERS, ROBERT (II)	RUSSO, RENE (I)
WRIGHT HOLMES, PRUDENCE	SIMMONS, HENRY (I)
ST. PATRICK, MATHEW	TATASCIORE, FRED
WICK, NORMA JEAN	TAIT, DOUGLAS
STADVEC, MICHAEL	TORRY, GUY
SHOWALTER, MICHAEL (I)	RIVERA, MICHAEL (I)
WARREN, GARRETT	TIKARAM, RAMON
STAHELSKI, CHAD	WHITE, MICHOLE BRIANA
REID, TARA	ROOT, STEPHEN (I)
SANCHEZ, JOHNNY (I)	WHITE, PERSIA
SILO, SUSAN	YUNG, SAI-KIT
SCOTT, JASON-SHANE	SHAIMAN, MARC
TEAGUE, MARSHALL R.	ROGERS, MICHAEL (III)
TAGER, ARON	WARD, MATT (VI)
PICKENS, JIMMY RAY	SMITH, J.W. (I)
WARNER, DAVID (I)	SHOWERS, MICHAEL (I)
SCHWARTZ, BEN (III)	YOUNG, COURTNEY SHAY
SANDERS, ALVIN	PINON, DOMINIQUE
THYNE, T.J.	WASKO, SANDY
SMITH, KEVIN (I)	PHILLIPS, NATHAN (II)
SIMPKINS, RYAN (I)	WILLIAMS, KALETI
TAN, PHILIP	WAYTON, GARY J.
WILLETT, CHAD	WONG, BD
SHEN, FREDA FOH	SMITH, DONNIE (I)
PHILLIPS, TRACY (II)	VACCARO, BRENDA
ROUILLIER, ROSS	TAKTAROV, OLEG
STRAUSS, PETER (I)	SPANJERS, MARTIN
SPENCER, OCTAVIA	RZA
SPEEDMAN, SCOTT	RADCLIFFE, DANIEL
TRACEY, IAN	SCHULL, REBECCA
REUBEN, GLORIA	VIRDI, HARVEY (I)
SAROSIAK, RONN	SCURTI, JOHN
PLEASENCE, DONALD	SPEREDAKOS, JOHN
SIMMONS, DERRICK	ROONEY, MICKEY (I)
PIEMONTE, PEEWEE	ROCK, JOHNNY (I)
STASHWICK, TODD	THEOBALDS, JOANNA
SCHULTZ, WOODY	THOMPSON, SUSANNA (I)
WILLIAMS, MICHELLE (I)	TUDYK, ALAN
SCRIBNER, DON	WILSON, DALE (I)
TAMBURRO, MICHAEL	UNDERWOOD, BLAIR
TAZIOLI, MARCO (I)	PROBETS, BRYAN
SMITH, MARK RHINO	TRACHTENBERG, MICHELLE
SPIRTAS, KEVIN	RUFFO, A. FRANK
TOOLAN, REBECCA	ZUCKERMAN, JOSH (I)
STRONG, JEREMY (I)	SYKES, ODESSA
STAMOS, JOHN	WILSON, RALIEGH
PINTO, FREIDA	SCOTT THOMAS, KRISTIN
SMITH, MIRIAM (I)	TOSAR, LUIS
SNOW, VICTORIA (I)	VANOVER, JILON
TOMLINSON, LESHAY N.	SWEENEY, STEVE (II)
SARABIA, RIC	WINKLER, MARGO
SPINKS, ANDREW J	STARK, JONATHAN (II)
REED, NIKKI (I)	REIDY, JOSEPH P.
WALSH, JERRY (I)	SKINNER, RICH
WEATHERS, CARL (I)	TORRES, LOU
SLOANE, LINDSAY (I)	TANIGAKI, KENJI
WONG, MING-SING	SPEARS, ARIES
YUEN, RUSSELL	PHILLIPS, MICHELLE (I)
STEWART, EWAN (I)	RUSSELL, BETSY
POLISH, MARK	POOLE, MARTIN (II)
SHAIFER, ANDREW (I)	WILSON, THOMAS F.
RICHMOND-PECK, DAVID	WINSLET, KATE
POVINELLI, MARK	ROBARDS, JASON
SUSMAN, TODD	SNEED, JOHNNY
WILLSON, PAUL (I)	SMIT-MCPHEE, KODI
STUDI, WES	RENNIE, CALLUM KEITH
SHANNON, VICELLOUS REON	VERGARA, SOFÌA
RUIVIVAR, ANTHONY	REVILL, CLIVE
WALSH, WENDY L.	ROBBINS, RACHAEL
PRINCESS, ANGEL	RAYNER, MARK (II)
TUPPER, JAMES	YAKUSHO, KÙJI
VERNIER, ADAM	THAL, ERIC
POLLOCK, ALEXANDER	WILLIAMS, AUSTIN (I)
ROSSI, TONY (II)	SOLIS, FELIX
POLK, STEPHEN	RIGA, PETER
VON BARGEN, DANIEL	VAN HETEREN, SANNY
SHEA, MCKENZIE (I)	SCOTT, LEIGH (II)
ZUCKER, CHARLOTTE	STEBBINGS, PETER
SMITH, KELLITA	PURCELL, DOMINIC
PORIZKOVA, PAULINA	SPRUELL, SAM
SPELLING, TORI	STERN, DANIEL (I)
SALLEY, JOHN	TUNNICLIFFE, GARY J.
SHACKELFORD, DAVID	VARGAS, JACOB
SPENCE, SEBASTIAN	WATKINS, MICHAELA
SLAYTON, BOBBY (I)	WEITZ, BRUCE
SMITH, BROOKE (I)	THOMAS, NATHAN ALAN
TYSON, BARBARA	ZACAPA, DANIEL
VIBERT, RONAN	TUEN, WILLIAM
SMITH, MAGGIE (I)	WALLS, LEON
READ, JAMES (II)	VINCENT, JAN-MICHAEL
SIRICHANYA, NIRUT	YOUNG, NANCY (III)
TALMADGE, VICTOR	SMITH, BRANDON (I)
POWERS, JAIME	RICHARDS, GENE (I)
RENNA, PATRICK	TENNANT, DEBORAH
SHEPHERD, SHERRI	PRALGO, ROBERT
TRAYLOR, SUSAN	WINSLOW, KATHRYN
SABATINO, JOE	TARBET, ANDREW
TAHAN, CHARLIE	SORICH, MICHAEL
SHEPPARD, WILLIAM MORGAN	STELLRECHT, SKIP
SCHNUIT, JASON	TRANDAFIR, CLAUDIU
STOLTE, CHRISTIAN	ROBERTSON, BRITT
ZIEFF, RICK	ROTH, BRENNA
WYNKOOP, CHRISTOPHER	WILHOITE, KATHLEEN
THOMPSON, REUBEN	SHANDLING, GARRY
RIVERA, RENE (I)	READ, KIM (I)
WORTHINGTON, SAM	WILSON, CASEY (III)
ROCHEFORT, JEAN	PORTER, LES (I)
WINCHESTER, PHILIP	WORTHY, CALUM
WERNER, ROY	QUESTELL, TUFFY
THOMPSON, JODY (II)	VAN PUTTEN, CHEKESHA
ROSETE, JOSE	PLUMMER, GLENN
SANTIAGO, ZAK	VALDERRAMA, WILMER
SEDLOCK, GARY	TOWNSEND, STUART (I)
THIERIOT, MAX	SINBAD
ZIEGER, FRANK	WOODESON, NICHOLAS
WOLFE, JEFF (I)	WILLIAMS, JUNIOR (I)
ROBERT, JOHN (I)	SNIDER, PETER (I)
TURMAN, GLYNN	SHANNON, MOLLY (I)
WELLS, DAVID (I)	SOLOWITZ, ALEX
SPEIGHT, LESTER	WRIGHT, AMY (I)
STARR, FREDRO	SMITH, JULIE K.
TOPOR, JOHN	WEST, CHANDRA
RICHARDS, CRAIG (I)	SMITH, WILL (I)
ZAHRN, WILL	WALKER, JONATHAN (I)
TAYLOR, JAMES LESLEY	QUIGLEY, GERRY (I)
SMITH, GREGORY PAUL	ROBERTS, ERIC (I)
STONE, TERRENCE (I)	TIERNEY, MAURA
WILSON, OWEN (I)	RICHARDSON, JOELY
VINCENT, DANIEL (III)	WEBBER, TIMOTHY (I)
VIRZI, JOE	PORTER, IAN (I)
YOUNG, BELLAMY	STROZIER, HENRY
PLA, CONRAD	WILLERFORD, BARI K.
SAPIENZA, AL	WASHINGTON, DENZEL
WILBORN, CARLTON	RICKARD, MARK
RODRIGUEZ, MICHELLE (I)	WEATHERLY, MICHAEL (I)
SMITH, DANNY (I)	ZOTTOLI, MIA
TOMITA, TAMLYN	STEYN, JENNIFER
ROWLANDS, GENA	UNION, GABRIELLE (I)
SAXTON, RICHARD	ROOKER, MICHAEL (I)
WOODARD, CHARLAYNE	SIMEK, VASEK
SHARIAN, JOHN	WILLIAMS, PAUL (III)
ROBERTSON, GEORGE R.	ROSARIO, JOSÈ RAMÛN
SLAUGHTER, BILLY	WANNAMAKER, MILLIE
STAAB, REBECCA	SCHMIDT, MARY ANN (I)
THOMPSON, DON (I)	SHATNER, WILLIAM
PORTER, SUSIE (I)	RAMPLING, CHARLOTTE
TODD, ANTONIO LEWIS	WHITTAKER, JODIE
SANDS, STARK (I)	PIERSON, GEOFF
TARANTINA, BRIAN	SALMON, COLIN
RITTER, JASON (I)	POSEY, PARKER
WELDON, LES	THORNTON, BRIAN (I)
SHEA, DAN (I)	WILSON, KRISTEN (I)
RUPP, DEBRA JO	THORNTON, PAUL (I)
ROBERTS, MARIO	WINFREE, RACHEL
THOMPSON, EMMA (I)	TYSON, CICELY
RYAN, GER	TAMBAKIS, PETER ANTHONY
SIMONINI, RICO	TELLER, MILES
VELAZQUEZ, NADINE (I)	STRZALKOWSKI, HENRY
ZANO, NICK	STONE, ROBERT (IX)
RUFFINI, GENE	WARD, JEFF (I)
STEPHENSON, BOB (II)	SHEIK, SAMMY
SPORLEDER, GREGORY	WALTER, HARRIET
RIEDINGER, JUAN	SALTER, SHANE
SHEEN, MICHAEL	RUSSELL BEALE, SIMON
TOM, STEVE (I)	ROBITAILLE, RICHARD
SEGANTI, PAOLO	STORM, T.J.
SAMPSON, PAUL (I)	ZIMA, MADELINE
SLOAN, PAUL	SAUNDERS, CLIFF (II)
ROTA, CARLO (I)	VENTURA, JESSE (I)
SYVERTSEN, PETER	WILSON, LAMBERT
THERIAULT, JANINE	SORIA, JOSEPH JULIAN
WOODBURN, DANNY	VOUYER, VINCE
SZOSTAK, STEPHANIE	SIMPSON, JAY (I)
POPE, CARLY	SKLAR, JASON (I)
UFLAND, CHRIS	STEVENS, CONAN
VARUGHESE, SUGITH	SANTIAGO-HUDSON, RUBEN
TUDISCO, JOSEPH	RUDOLPH, MAYA (I)
RATHBONE, JACKSON	SHARMA, REKHA (I)
TESTER, BRIAN (I)	VENTIMIGLIA, JOHN (I)
SCHULZE, MATT (I)	WALKER, AMANDA (I)
VILLABONA, STEFANO	ZAPPA, WILLIAM
SKOG, TROY	TAYLOR, CHRISTINE (I)
VALDEZ, JEREMY RAY	ZANNI, CHIARA
WILSON, JONATHAN (I)	WARNER, GLEN
ZACHAR, ROBERT	REEDUS, NORMAN
WERT, DOUG	RICHMOND, BRANSCOMBE
VINCENT, BARBARA (I)	WALCH, HYNDEN
WELLS, JULIAN	WHITCHURCH, PHILIP
WARNABY, JOHN	REGAN, MIKE J.
PRAEL, WILLIAM	STEPHENS, LOUANNE
STADULIS, CHRISTOPHER	ULLMAN, TRACEY
RADLEY, KEN	WALKER, NICHOLAS (I)
TECHMAN, CHARLES	WHITSETT, LAUREL
SAGASTIZADO I, TONY	RUDULPH, KEN
WILCOX, SHANNON (I)	TUAN, SHU LAN
SEDGWICK, KYRA	SERANO, GREG
REARDON, NOREEN	SCHMID, KYLE
SLABAKOV, ANDREY (I)	SCOTT, JOHN-CLAY
WADE, MADELEINE	ROLSTON, MARK
SOBALO JR., JOE	PORTNOW, RICHARD
QUAID, RANDY	WARBURTON, PATRICK
REES, ROGER	WAITE, RALPH
WEAVING, HUGO	STEINBERG, ROB (I)
ZEMAN, RICHARD	WHEATON, WIL
STARR, BEAU	THOMAS, EDDIE KAYE
SMART, JEAN	WEBSTER, DEREK (I)
SPINER, BRENT	SUCHARETZA, MARLA
PIVEN, BYRNE	WHITE, RON (I)
PINNOCK, ARNOLD	STEVENSON, CYNTHIA
POST, TIM	WALSH, JACK (I)
RANNEY, CHRIS (I)	PLANCHE, VALERIE
RUCKER, LAMMAN	TAYLOR, HARRY (I)
ROBERTS, ELIZA (I)	WALLS, ALLEN
SPAHIU, GABRIEL (I)	RIVERA, EMILIO (I)
SAXTON, CHARLIE (III)	RITSON, BLAKE
RODGER, STRUAN	POOLE, AARON (I)
SCHROEDER, TODD (I)	PIERCE, DENNEY
SINGLETON JR., ISAAC C.	POOR, BRAY
SZIBLER, STEPHEN	PIERONI, DONNA
WIMMER, BRIAN	ROBERTS, KEN (VI)
ZHANG, ZIYI	SMITH, TIM J.
WILLIAMS, BRANDEN	ROBBINS, KATE (II)
RADECKI, BARBARA	WHITE, MICHAEL JAI
RANDAZZO, KATHLEEN	SMITH, ROBERT (XVIII)
SHAW, VINESSA	SMIAR, BRIAN
WARD, SUSAN (I)	SOSSAMON, SHANNYN
WIIG, STEVEN	WILSON, RAINN
SHORTT, PAT	TENNANT, RUSTY
SIMMONS, J.K.	STEVENS, BRINKE
TAMMI, TOM	RAY, CONNIE (I)
VARTAN, MICHAEL	VAROD, SHELLY
TAYLOR, DUB (I)	PRUNTY, MEREDITH
WRAITH, ALEX	SAXON, JOHN
TROYER, VERNE	ROBARDS, SAM
POTTER, MONICA (I)	VANSITTART, RUPERT
TEEGARDEN, AIMEE	SAVENKOFF, ELIZABETH CAROL
STAINES, KENT	VERD˙, MARIBEL
SIEMASZKO, NINA	ROUTMAN, STEVE
POLLARD, MICHAEL J.	RIBISI, MARISSA
WHIRRY, SHANNON	TUCCI, STANLEY (I)
TOMLIN, LILY	POLITO, JON
SAWYER, CONNIE (I)	WATSON, KEVIN (I)
TIERNEY, JACOB	WILLIAMS, PETER (IV)
WONG, BENEDICT	YULIN, HARRIS
WILLIAMS, TREAT	RAYMOND, USHER
TRAINOR, MARY ELLEN	WOODS, JAMES A.
ROCHON, LELA	YAKOVLEV, ANTON (I)
WALLACE, GEORGE (II)	WARE, LANETTE
THOMAS, MARCUS (I)	RAD, MIKE
SHANKS, DON	WILLIS, BRUCE
TURNER, KATHLEEN (I)	TULL, CLYDE
WRIGHT, BRUCE (I)	WILSON, DEBRA (I)
SEIBEL, MARY	PLACE, MARY KAY
SILVERMAN, SARAH	SPRINGER, JERRY
REEVES, PHIL (I)	SPENCER, MARCUS D.
VAN HOUTEN, CARICE	RUBINSTEIN, JOHN
SIMON, CHARLES (II)	PIERPOINT, ERIC
STEWART, PAUL (II)	RUSSOM, LEON
SANCHEZ, VICTORIA (I)	WHITAKER, FOREST
SHUM JR., HARRY	STRANGE, PATRICK MICHAEL
WEI, DICK	YEO, GWENDOLINE
SCHWARTZMAN, JASON	THORNTON, KIRK
RIPA, KELLY	WARD, SELA
TAYLOR, REGINA (I)	TOWNSEND, STANLEY
TAY, SHARON	PRESCIUTTI, AMERICO
VAUGHN, ROBERT (I)	UZZAMAN, BADI
ZLATAREV, GEORGE	WILDMAN, VALERIE
SKARSGÂRD, ALEXANDER	WHITE, MIKE (I)
RATCLIFFE, BARRY	TUNG, BILL
WILDE, JUNE B.	WILLES, CHRISTINE
VAAS, JOHN ANDREW	STEWART, JON (I)
WOLOV, JULIA LEA	STAMATOV, STANIMIR
POINDEXTER, LARRY	TOBOLOWSKY, STEPHEN
PHILLIPS, SAMANTHA (I)	PISTOR, LUDGER
SHUSTER, RICK	SHACKELFORD, ERIC (II)
TRITT, TRAVIS	WISNIEWSKI, ANDREAS
WHITE, JOHN PATRICK	SEXTON, BRENT
TRUE, RACHEL	PRYCE, JONATHAN
WOLF, MATTHEW (I)	WARNER, CINDY (I)
VAN VILLE, MAX	SPIEGEL, SCOTT (I)
ROBERTS, DOUG (I)	ROMANO, CHRISTY CARLSON
POWLEDGE, DAVID	SMITH, TASHA (I)
TAYLOR, LAWRENCE (II)	SCHROEDER, GEORGE
SERAFINOWICZ, PETER	TORRY, JOE
RITTER, PAUL	RHAMES, VING
RATHER, DAN	PÈRE, WAYNE
TALOR, VENESA	WIDDOWS, CONNOR
VON FRANCKENSTEIN, CLEMENT	STURIK, OLA
ZOLI, WINTER AVE	WHITFIELD, CHARLES MALIK
VERZELLO, PIERO	WHEELER, JANE
SCOTT, ANNELIZA	TIMBERLAKE, JUSTIN
VANCAMP, EMILY	WALSH, ROBERT (I)
ROURKE, MICKEY	STAUBER, LIZ
PRICE-FRANCIS, AMY	PHOENIX, JOAQUIN
VALENTINE, STEVE (I)	VAN DE KAMP BUCHANAN, RYAN
ZABRISKIE, GRACE	THOMPSON, SCOTT 'CARROT TOP'
SANDLER, JACKIE (I)	WALLACE, WILL (I)
SKYE, AZURA	RIECK, BILLY
ROXBURGH, RICHARD	RIPKE, MAURICE
WILLARD, FRED	SPECTER, RACHEL
ROSARIO, JOE (II)	WATSON, GEORGE F. (I)
SCOTT, SEANN WILLIAM	ROSS, VANESSA (III)
SHAVERS, CHINA	WHITFIELD, LYNN
RUNYAN, TYGH	PYLE, MISSI
WATTON, JONATHAN	STOLE, MINK
RIDINGS, RICHARD (I)	SMITH, LIZ (I)
ZETA-JONES, CATHERINE	VARELA, LEONOR (I)
TENCH, JOHN	ZUMO, LYNETTE
ROSCOE, GARY	RAVEN, ELSA
TROTTER, KATE	WEBB, VERONICA
VASUT, MAREK	REYNOLDS, MICHAEL J.
RUGE, GEORGE MARSHALL	TABAKIN, RALPH
SKARSTEN, RACHEL	PURCELL, JAMES
WILLIAMS, VANESSA (I)	SHEH, STEPHANIE (I)
RILEY, TALULAH	WOODS, BARBARA ALYN
VALLETTE, FRANKLIN A.	STEVENS, DANE
RADLEY, XANTHA	SHEPARD, DAX
VANG, LEE (I)	PIDGEON, REBECCA
SANDERS, CHARLES (I)	RINGWALD, MOLLY
VELNICIUC, STEFAN	WYNTER, SARAH (I)
TAHAN, DAISY	TITONE, CHRIS
QUINN, ANTHONY (I)	SESSIONS, JOHN (I)
WOODHALL, LESLIE	ROBSON, WAYNE (I)
ROBINSON, CHARLES (I)	VIRTUE, TOM (I)
WARSHOFSKY, DAVID	RYAN, MAX (I)
WHITTAKER, JONATHAN (I)	TOUSEY, SHEILA
WORONOV, MARY	TAYLOR, JOSEPH LYLE
SHOPOV, HRISTO	SBARGE, RAPHAEL
TRAVIS, STACEY (I)	SHYER, CHRISTOPHER
VANOVA, APOLLONIA	STEVENSON, RAY (I)
WILSON, REBEL	SHARPTON, AL
ROGERS, LAURA (I)	WEBBER, MARK (I)
SAVADIER, RUSSEL	REILLY, JOHN C. (I)
WINTERS, TIME	WYSS, AMANDA
WASSERMAN, ALLAN	THORSEN, SVEN-OLE
THEERATHADA, DON THAI	SCOTT, KIMBERLY (I)
YOON, JEAN (I)	SCHANAMANN, CHUCK
SERGI, BRAD	WYATT, LISA K.
RHODES, GUS	POPPLEWELL, ANNA
STOKES, CHRISTIAN (I)	URY, DAVID
SCHERER, MICHAEL (I)	STERN, JENNA
THOMPSON, BRIAN (I)	WINNINGHAM, MARE
STEWART, MCKAY	YUILL, JIMMY
VISNJIC, GORAN	WALKER, KERRY (I)
STANDING, JOHN	STRANGE, RICHARD (I)
SANDS, JULIAN	WOLF, NICKOLAS
QUADROS, STEPHEN	RIVIEZZO, VINCENT
VAUGHN, TERRI J.	VAN WORMER, STEVE
STEUART, JACQUELINE ANN	ROBINSON, JOHN (V)
SHARP, TIMM	SMITH JR., LONNIE R.
TUCKER, JONATHAN (I)	SARACINO, BERNARDO P.
WEST, KEVIN (I)	WILMOT, JOHN (I)
SAGAL, MCNALLY	POITIER, DAMION
SHRAKE, WARD	RICHARDSON, NATASHA
WU, MA	STEVENSON JR., CHARLES C.
TELEK, APRIL	SISSONS, KIMBER
TARANTO, GLENN	WELSH, KENNETH
SMITH, WILLIAM (I)	STATHAM, PATRICK J.
WIGGINS, AL	STEWART, JOHN (XXIV)
SOKOLOFF, MARLA	RUSSO, VINCENT JAMES
SHELBY, JOE	VAN PATTEN, JOYCE
VICTOR, RENEE (I)	WALSH, VINCENT
WERLEY, JAMES	QUARTAROLI, PETER
REDMOND, SARAH-JANE	WITTING, STEVE
STERLING, RACHEL	ROCILILI, BIANCA
SIZEMORE, TOM	WHITFIELD, DONDRE
STALIN, JOSEPH	SHEFFIELD, JEREMY
ROEMER, SARAH	THOMAS, BRYAN (III)
VON ROON, ALEXANDER	SIMMONS, JOHNNY (I)
WENTWORTH, ALEXANDRA	WOLF, SCOTT (I)
SEGAN, NOAH	ROBEK, KIRSTEN
WATANABE, KEN (I)	TAKENAKA, NAOTO
SKERRITT, TOM (I)	PRINE, LYSSA
SARA, MIA	WILLIAMSON, FELIX
ROTH, ANDREA (I)	WHITFIELD, MITCHELL
RUCK, ALAN	RHODES, DANE
SANDERS, JEFF (I)	WILDE, OLIVIA
WIEBE, CAINAN	PROCTER, EMILY (I)
SHAWKAT, ALIA	WEST, SHANE (I)
REUBENS, PAUL	WILLIAMS, JOBETH
WALTERS, MARK (I)	ROSSELLINI, ISABELLA
WARNAT, KIMBERLEY	ROSE, MICHAEL (XXI)
RUPAUL	QUILL, TIMOTHY PATRICK
WEISMAN, KEVIN	RAMOS, LUIS ANTONIO
YAM, SIMON	THEBA, IQBAL
SMITH, CHAZ	WINTERS, SHELLEY
THOMAS, DAVE (I)	WHISHAW, BEN
ROCCO, ALEX	WUHL, ROBERT
WELKER, FRANK	WATERS, DEREK (I)
VAN DIEN, CASPER	STOLLER, FRED
SHUE, ELISABETH	SHEPIS, TIFFANY
WILSON, PATRICK (I)	SERGEI, IVAN (I)
STONE, MATT (I)	SIEMASZKO, CASEY
ROSE, GABRIELLE	PINE, ROBERT (I)
VAN WERT, DAN (I)	SOWERS, SCOTT
TURK, BRIAN	TALIFERRO, MICHAEL
SHEN, PARRY	SMITH, ROBIN (I)
SQUIBB, JUNE	RIBISI, GIOVANNI
WALKER, CHARLES (I)	RAWLINGS, JAMES (III)
THOMPSON, SOPHIE (I)	TYLER, DENEEN
SNYDER, DREW (I)	THORNTON, BILLY BOB
WARNER, RICK (I)	STEVENS, FISHER
RONAN, SAOIRSE	VILLANOVA, KIMBERLY
REEDER, RANDAL	URICH, JUSTIN
YEARWOOD, RICHARD	WALLACE, BASIL
ROTHHAAR, WILL	VAHANIAN, MARC
SHERIDAN, JOE (I)	SADIE (II)
SCARFE, JONATHAN	TRIMBLE, SCOTT
ROBBERTSE, DAN	WATTS, NAOMI
TUCKER, CHRIS (I)	RUDIN, STUART
SCANNELL, KEVIN	WRIGHT, ALOMA
WOOLVETT, GORDON MICHAEL	WEST, DOMINIC
SHORT, COLUMBUS	VAHLE, DIRK
SHEPHERD, JACK (I)	SCOTT-MASSON, WILLIAM
SADLER, WILLIAM (I)	ROTHMAN, JOHN (I)
TREVISI, FRANCO	PNIEWSKI, MIKE
YUK, HENRY	WALTON-WALKER, PEGGY
WARD, ZACK (I)	TALANCÛN, ANA CLAUDIA
SIMMS, TASHA	RILEY, STU 'LARGE'
SCIÚ, YVONNE	THOMAS, SEAN PATRICK
WORMALD, KENNY	RUEHL, MERCEDES
STANSFIELD, CLAIRE	RAGSDALE, WILLIAM
SKYE, IONE	VALLEY, MARK (I)
ROBERTSON, KATHLEEN (I)	YORKE, TROY
SMALLWOOD, TUCKER	RALPH, JAMES (I)
ROSS, DARREN (II)	STONE, STUART (I)
ST. JOHN, MARCO	WEST, MEMI
STALEY, STEVE (II)	STALLONE, FRANK (I)
TOBECK, JOEL	WILLIAMS III, CLARENCE (I)
ZERBE, ANTHONY	TORRES, LIZ (I)
STEIN, SAUL	PRUETT, JESSE
WILLIAMS, TROY (II)	UNGER, DEBORAH KARA
YOUNG, DAMIAN	STARR, ARNE
PIGOTT-SMITH, TIM	SANADA, HIROYUKI
SCHAEFER, JOSHUA	QUINN, FRANCESCO
STEA, KEVIN ALEXANDER	ROSAN, DEBORAH
TURNER, JIM (I)	STEPHENS, CLIFF
POUGET, ELY	RIGGLE, ROB
PODELL, EYAL	RADELET, PHILIPPE
TEASTER, DEAN	RIDDICK, JACINTO TARAS
STOLL, COREY	WATSON, BUD
SEACAT, SANDRA	ROSS, CHELCIE
WARE, ANDRE (I)	PINKHAM, TYRONE
REED, PAMELA	SCHRADER, KEITH
STELLATE, NICK	ZEM, ROSCHDY
QUON, DARRYL	TANAKA, YÙJI (I)
YUEN, COREY	RATCHFORD, JEREMY
SHURE, GILLIAN	WEBER, STEVEN (I)
PRYOR, NICHOLAS (I)	RICHARDSON, JACKIE (I)
RUBES, JAN	ROSS, VALERI
PIRO, GRANT	RUEHL, FRANKLIN
STENBORG, HELEN	SCHOMBING, JASON
SHAW, KRISTEN (I)	REYES JR., ERNIE
PIKE, GARY	WALKER, CRAIG (I)
SUMMERTON, KAREN	SARRAZIN, MICHAEL
THOMAS, ROBERT (V)	SANDERS, JAY O.
PUTCH, JOHN	STRATFORD, TOM
VIGUS, LARRY	WILDER, ALAN (I)
TIGHE, KEVIN (I)	WARD, FRED (I)
WESTWICK, ED	SYMS, RICHARD
WAGENINGEN, YORICK VAN	WEBB, DANNY (V)
REED, TANOAI	RICHARDS, CORDELIA
SMITH, LINDA (I)	ROCKET, CHARLES
TRAVOLTA, JOEY (I)	VANDER, MUSETTA
WINCHESTER, MAUD	WATERS, JOHN (I)
SCOGGINS, TRACY	RAPP, ANTHONY
WATSON, EMILY (I)	RIPPY, LEON
RODRIGUEZ, ADAM (I)	STEPHENS, TOBY
RICHARDS, DENISE (I)	TOOTOOSIS, GORDON
TURTURRO, JOHN	SCHIFF, RICHARD
SCHIAVELLI, VINCENT	VAUGHN, JUDSON
WILLIAMS, PHILIP (I)	WILSON, JODY (I)
SELBY, DAVID (I)	ROWAN, KELLY
PICKETT, CINDY	TOLES-BEY, JOHN
TURNER, TYRIN	SCOTT, DONNA W.
WILLIAMS, ELLIS	SMITH, MARY JO (I)
ROTHCHILD, ROLAND	SINCLAIR, MALCOLM (I)
RAMIS, HAROLD	SHIRKOFF, BETHOE
WALTER, TRACEY	SPORE, RICHARD
WOOD, ANNIE (I)	YOUNG, CEDRIC
WALLIAMS, DAVID	PICKUP, RONALD
WISE, BILL (I)	QUINN, IRIS
SHAPLIN, PAUL	WASHINGTON, CARL (I)
SPARKS, PAUL (II)	SCHIFTER, DAVID
YORK, FRANCINE	SIPOS, SHAUN
RODRIGUEZ, RAMON (II)	WRIGHT, JEFFREY (I)
SHAFER, ROBERT R.	WESTON, MICHAEL (I)
ROBERSON, BILL	SEALY-SMITH, ALISON
SKARSGÂRD, STELLAN	WALKER, BOB (XIV)
WOOLVETT, JAIMZ	SASSO, WILL
PICCIANO, GINO	RENFRO, BRAD
RILEY, MICHAEL (I)	WINGFIELD, PETER
TEIGEN, MICHAEL	SANDLER, SADIE
RENTERIA, GEORGE	RAEKWON
WORTHINGTON, WENDY	ROUSE, EDDIE (I)
YIP, WING-CHO	YOHNKA, MERRITT
TYLER, LIV	ROSE, ROGER (I)
SERPICO, TERRY	PRESTON, WILLIAM (I)
STEENBURGEN, MARY	SUMNER, JOHN (I)
STAHL, NICK	SAN GIACOMO, LAURA
POGUE, KEN	SHAW, MORGANA
SHIVER, ARRON	RAMSAUR, MATTHEW
REED, LOU	TYGH, RYAN
VAN SWEARINGEN, GUY	RIVAS, GEOFFREY
RETTA	VANN, MARC
SULLIVAN, BRAD (I)	PIZANO, BEATRIZ
VALENTINE, SCOTT (I)	THOMAS, BRUCE (I)
TERMO, LEONARD	THOMAS, JONATHAN TAYLOR
SOMERVILLE, GERALDINE	RASHAD, PHYLICIA
WC	T·BORSK˝, MIROSLAV
TIMBES, GRAHAM	WYNORSKI, JIM
TOMEI, ADAM	WOODBINE, BOKEEM
RICHARDZ, SHAWN M.	WILLMOTT, DAN
WRIGHT, TOM (I)	SMITH, LIONEL MARK
RYDELL, CHRISTOPHER (I)	VOIGHT, JON
POITIER, SIDNEY	SIKES, LORI BETH
YOUNG, NINA (I)	VINCENT, FRANK (I)
VALENTI, DUKE	THORNE, CALLIE
WEEKS, GARY (II)	PYPER-FERGUSON, JOHN
SETTLE, MATTHEW (I)	TUNNEY, ROBIN
RODEN, KAREL (I)	STEWART, BOBBY (I)
STEWART, ROB (I)	PRIMUS, BARRY (I)
STILLO, JANINE	ROEBUCK, DANIEL
SNIPES, WESLEY	YIP, FRANÁOISE
SADLER, NICHOLAS	STABLES, KELLY
STRONG, DANNY	TESCH, INGRID (I)
TATE, LAHMARD J.	YANG, JAMISON
WILCOX, RALPH (I)	ROBINSON, KEITH (III)
RENNISON, COLLEEN	SOWERBY, JANE
VAN VARENBERG, KRISTOPHER	Q-TIP
WELBORN, JUSTIN	ROSEMONT, ROMY
SPACEK, SISSY	WISEMAN, MICHAEL
SARANDON, CHRIS (I)	RAJSKUB, MARY LYNN
RICHARDSON, IAN (I)	WALTERS, BILL (IV)
ROSS, RICCO	SMILEY, MICHAEL
WADHAM, JULIAN	SHUTTLEWORTH, DARYL
PRESLEY, A.J.	SCHELL, MAXIMILIAN
SILVER, LEONARD (I)	POWELL, COLIN (I)
WESTERMAN, FLOYD 'RED CROW'	SPINK, DANIEL (I)
ZACARÌAS, GIOVANNA	SCHRAM, BITTY
POWELL, GLEN (I)	VIELUF, VINCE
STUART, JASON (I)	WEIGERT, ROBIN
SWAYZE, PATRICK	SANTILLAN JR., MAXIE J.
WALSH, J.T.	POWELL, CHARLES EDWIN
WINFREY, OPRAH	RANKIN, KEVIN (I)
WYLIE, ADAM	RODGERS, MICHAEL E.
STEWART, MALCOLM (I)	SKRABANEK, WILLIAM VICTOR
WILLIS, SUSAN (I)	WILCOCK, ROBIN
TUCKER, SEAN (I)	WELLS, TICO (I)
SKAGGS, JIMMIE F.	SALINGER, DIANE
SIKORA, JOSEPH (I)	SZOHR, JESSICA
SEVERANCE, JOAN	SOTTO, AL
UNGER, JOE	PRUNER, KARL (I)
STUHLBARG, MICHAEL	RESLER, FRED
VANARIA, LOUIS	PICKETT, ERIN
PORTAL, ROBERT	SEIGNER, EMMANUELLE
RYDER, WINONA	SMITH, GREGORY (I)
SCUDAMORE, STEWART	WILLIAMS, HEATHCOTE
UNDERWOOD, JAY (I)	SCINELLI, SANTI
STRICKLAND, KADEE	SIMMONS, GENE (I)
SHINKODA, PETER	SHELLY, ADRIENNE
TIERNEY, LAWRENCE	RUBIN, JENNIFER (I)
RIPPY, MATT	TRAVOLTA, JOHN (I)
STONEHAM SR., JOHN	ROSE, LENNY
SANTIAGO, JOHNNY (III)	ZOMBIE, SHERI MOON
SIGEL, BEANIE	SHEARER, JACK
TAYLOR, LILI (I)	SEVIER, COREY
YAZPIK, JOSÈ MARÌA	WILLIAMS, BRIAN J.
TYLOR, JUD	YEUNG, BOLO
YOUNG, KEONE	PIERCE, WENDELL (I)
YRIBAR, JASON	THOMASON, MARSHA
REA, STEPHEN (I)	PILON, DANIEL (I)
UPTON, SAM (I)	WARD, MARIE
SLOTNICK, JOEY	ROHNER, CLAYTON
THORNTON, DAVID (I)	TUCKER, BURNELL
SREBREV, ATANAS	VINCENT, CHRISTIAN (II)
ROLAND, SCOTT	SWANK, HILARY
TREVEILER, ROBERT C.	PROCTOR, TOBY
ROMANUS, ROBERT (I)	SANZ, CARLOS (II)
REYNOLDS, BURT (I)	WHITE, BERNARD (I)
ROSS, SANDI	STARKS, TIMOTHY
WINNICK, KATHERYN	TAYLOR, COURTENAY
YOUNG, ROBERT A.	SOBIESKI, LEELEE
PORTER, STEVEN M.	SELDES, MARIAN
SCHWEIG, ERIC	SEYMOUR, JANE (I)
SCARBER, SAM	WEST, JULIA FAYE
PORTER, SCOTT (III)	TRUTER, GREGOR
VEGA, PAZ	WRIGHT, TRACY (I)
TAYLOR, HOLLAND	TANNER, RICHARD (I)
WARREN, ESTELLA	ZAJONC, ROBERT 'BOBBY Z'
RAMSAY, ANNE (I)	ROCCA, STEFANIA
Z, JAY	TAMBLYN, RUSS
SWING, CATHERINE	UZIMANN
VILLANI, MICHAEL	WILSON-SAMPRAS, BRIDGETTE
VORONINA, IRINA	VOSLOO, ARNOLD
WASHBURN, RICK (I)	ROMANOWSKI, BILL
RUDDER, MICHAEL (I)	STERCHI, WILLIAM
WILDER, JAMES (I)	VON PFETTEN, STEFANIE
RIMMER, SHANE	RHEE, LIL
SCARPA, RENATO (I)	SCIUTTO, NELLIE
WELLER, FREDERICK	SCARWID, DIANA
STOREY, HOWARD	WOOD, MATTHEW (I)
REBELO, NICKY	POSTLETHWAITE, PETE
TUIASOSOPO, PETER NAVY	SMITH, AMBER (I)
TENNANT, DAVID (I)	YEAGER, BIFF (I)
WEBSTER, GLENN (I)	WILDING, SPENCER
SCIONTI, STEVE	THOMASON, MARK (I)
WOLFE, COLLETTE	SAINT, EVA MARIE
POLIZOS, VIC	TRUJILLO, RAOUL (I)
SPROUSE, COLE	WALSH, M. EMMET
RYAN, TRACY (I)	SMOLLETT-BELL, JURNEE
RENADAY, PETER	TRIPPLEHORN, JEANNE
PIERCE, BROCK (I)	SHAKUR, TUPAC
REGIS, MARSHA	VESSEY, TRICIA (I)
ROBINSON, CRAIG (I)	ROBERTS, BRET
THOMAS, ROHN	THOMAS, RAYMOND ANTHONY
SEYMOUR, CAROLYN (I)	STEIGER, ROD
ZIMMER, CONSTANCE (I)	REALBA, MIKE
RIBUSTELLO, ANTHONY J.	WALLACE, THOMAS
VARNADO, LAWRENCE	SERBEDZIJA, RADE
SEYFRIED, AMANDA	WILLINGHAM, NOBLE
SKELTON, STEWART	TARI, EGIDIO
VAN PEEBLES, MELVIN	SINGH, DESI
RANDLE, THERESA	TAUTOU, AUDREY
SHADIX, GLENN	SERRA, RAYMOND
